####B################
#### #   ########   #
# ## ###  ##      # #
# #  #### ######### #
#   ##    ##      # #
#  ### ##    #### # #
# ########## ####   #
# #    # ##    #### #
#   ## #    ## #  # #
###### ####### ## # #
#    # ####    ##   #
#### #  #   ####  # #
#    ## # # ####### #
# ##### # # #   #   #
# ##    # # # ### ###
# ## ###### #   # ###
# ## ###### ###   # #
# ## ###    ### ### #
#    ### #####    # #
####   # ##### ## # #
######   ##### ##   #
##############A######